######################################
#                                    #
#                                    #
#                                    #
#                                    #
#                                    #
#                                    #
#                                    #
#                                    #
#          P                         #
#                                    #
#                                    #
#                                    #
#                                    #
#                                    #
#                                    #
######################################
